{
    "1446": {
        "9": "28/02/2025",
        "10": "29/03/2025",
        "11": "27/04/2025",
        "12": "27/05/2025"
    },
    "1447": {
        "1": "25/06/2025",
        "2": "24/07/2025",
        "3": "23/08/2024",
        "4": "21/09/2025",
        "5": "21/10/2025",
        "6": "20/11/2025",
        "7": "20/12/2025",
        "8": "18/01/2026",
        "9": "17/02/2026",
        "10": "19/03/2026",
        "11": "17/04/2026",
        "12": "16/05/2026"
    }
}
